%%%%%%%%%
% P    .% 
% % % %%%  
%    .%%% 
%%%%%%%%%
